NO textures/bicho.png
SO textures/henry.png
WE textures/momoa.png
EA textures/mou.png

C 60,65,88
F 0,158,65

         1111111111111111111111111
        10000000001 100000000000001
        10110000011 110000000000001
        1001000000010000000000001111
    11111111011000001110000000000001
   100000000011000001110111111111111
11110111111111011100000010001
11110111111111011101010010001
11000000110101011100000010001
100000001000000011000000100011111111
1000N000100000001101010010001
1100000111010101111101111000111
11110111 10110101 11111010001
11111111 1111111 111111111111