NO textures/bicho.png
SO textures/henry.png
WE textures/momoa.png
EA textures/mou.png

C 0,0,255
F 60,179,255

1111111  
 110000111
100S1111  
1111      